########
########
########
...C....
S.C..C.F
########
########
########
