#######F
C...###.
.##.###.
.##.###.
.##C...C
.#######
.#######
S#######