####FC##
####..##
####.###
####C###
S.CM.###
########
########
########