########
########
S.######
#.C#####
##.C####
###.C###
####..##
#####F##