########
###F####
###M####
##.C####
##M#####
#.C#####
#M######
SC######