########
########
#CCMMMCS
#F######
########
########
########
########