........
.C......
......C.
..###...
........
........
.#..C...
S......F