........
.M...#..
.#C.....
MMM#MMMM
S.CCCC.F
MMM#MMMM
....#...
........
