S.......
.M...#..
.#C.....
.M.#....
....C.#.
..#..MM.
....#...
.......F
